rzg: nvg
jgc: dms dph mkb gqg zqp bqc vqq lfc
tfx: gwn gmg srn
fmq: gpg kjz glm
nlk: pbc kwf xqx bzl tsv qbh krc
mgb: lwr fpd lbm csg qxl vgk
snz: lfr zcc bzj kvd zqp bdf mxg hcx
sdv: tqf fcm zvw
jxv: lfr gxn ghn nvg flj jdx
css: rlw nhz cmm rdr
nkk: pbz rrs stf flv bqh fmb
hpg: vbx
zvw: zhd sdv
dxh: ngk jrz ppb bdz phg lzd frk vxt xts
shj: ctn prx bxs qjj dfz blw jtj fmj lsk nvl wbm
qml: gkn wpj fwq tbz zrd jgf
vsx: zqr nsj fcf fqg dhk dss
lkz: qkj glk fwq zcd xfm
lsv: nfn cxp gnd mwz ppb
qlh: wxm csh lxh dbk hgl whn
vsr: qrw zds zrd mdl sjb tpb kcq
npx: brs xpx gzd
scw: kdk kff rjf pxj
wpp: cgv xdp lkt jgk
cnk: tfq zqn
rld: brp
bgt: gdb vxm
nlb: skh hqq cht
dfc: cjz vxm rqt
ksk: wxc tnr gbb czh mwt lrc xbq hxk cjf lpt vmf wzl
lvb: vnb wtw tjp kgd sch
bhn: tpc dsw gbr
wvc: jcv nck rrs
tkv: bnh lkt
lrd: xdp ldn srt qsf
ppm: hmb mfd mvh pvq
nvh: bbv dnq lhf
blw: fhz ffl
rvm: zpn dss vtf bdg gbr xcz tfr tkb
mgx: pxr dcz rxt
dgw: hcs rmb lxw tgk
ntz: vcq vwk zlk
sbc: vjj
dxz: dlj lxw vlv wxr slw
gzq: txw hrz
mkl: zlk fjm mbk vtx
xsz: fkm hnk slh wtf gmz hhm hmj
pgn: ctp tcl lwj pfr
vmd: hsh cst
mnn: zsd bgw zfw ppv pvp sls hfg
mkn: pqd fsh bdz nsr
dmg: jzb xqg vnf nlb dpx
gkv: hxr plk cgv qtb
dsw: zpw fmj bhn
vpb: psq kwg ddx fgv
lrk: cst lrp mkx hkq vml rsg kvd
ztl: gvd kdk ffw lwr sts mrg
bpl: bhw tdx cvd twb krr vjj qgq ftb gcn
rcv: ddj lwr zdl xsl fdb vsg
xjm: zcc kfm hbw llf hhd
gtp: tpm jjk zbt
mfd: rrl ppm
wgz: rcl dsm zxz lkt nsv cdj knx
gfj: vmc gsk tsz
tpp: zxb qmz zjs lrw jzb lpn dcz tdh jbr tvs
rgm: vhg rvc cft wpx
kmp: gbr dnz rxq ssj qwl klv
hnp: hpj hrp mrp qdk dbn zwg jfz rjp qhq
xcn: sck qdq
gkx: fzh xkv dxb wpc cdg pbq fsv drj
kxz: nsw gzs hrz vqg mlx tpv pfz cqc wcx sqf blm
bgw: mnn chc
rvw: bkk dph nwd kdp rnv
htk: prx kdr mdf dms klg
bbg: jsf nzt rpw xdx
zpn: rvm wlw flj cwm
tcl: fpd wtt ppb pgn hzd bqh tbq
bpw: lhl xpt
pzt: rxj xzj wtp nhh gnf cjn
gtf: jlc zvg
vwh: rdq mdb nsr bvz
ppb: dxh qsh
sgr: llt ssg mlx
cjx: vhc fpq rbt
fjn: zpl
bqw: tmk xfc blw
dfz: shj dzq sls jfz
cqz: vkt mgv pzq psk mdq
fmj: smd vhc dnm shj zcx dsw bgt
flj: zpn wgk jxv zpl vql sjb mhb gmq
whm: ctg dtd
fzc: qww vsb xpv jfn fpk pgv tdf
kpc: hzr cgv rxz gjl
srb: lgt rbt jgp
xnk: bvq bvz mwt
hdj: jhh nrj lpl fvr mkb nvq tks xtb ctj
rdh: wdn ptv nck
nvg: gbr qnj jxv klf rzg
nqm: rsv pgv rgb krz qpc zsg tvp
frr: blt qcq
ctn: txj rsc
kjm: tkt qgq sjj fdb nsv xkh pbc
gxm: wms rnx xgj
hbg: bvp dvx vql nvs bgt vqq qvt
ksm: sck cjn lbd
fpq: nsf lgm mrq tfc tbz cjx
nhz: css tzf cqd mcv
rbt: kwv srb cjx
pgl: pgw rvx bbx zvx pzp nbz
skd: rhw pkh qmf
wrc: dth lxw ngs
lsx: vwk csx qdq
cls: gtf wtf qpk fqq sqf
wtw: vmh rqt lhr lpl lvb cbf lmb
bvw: shm whm rsh kft
wpc: gkx
ndc: shm brt ptl wrc qbh hzx krt
pcr: cpd njv lqp bvq gst
gjg: dfp gjk gbm
qrw: gpq zhq qmf dnd vsr
dkt: rzz rrc pnx brh
nbg: vqh mpc dnd vwn
zsn: kvl dzq prx qsg
csk: wpx pbz wcf tvp
gqf: hzr npw lpb jbd hcs
zqb: spb ptl sjr
zqw: xqp tqw
kjf: bck tjp mqr rrf
qgl: ghj bzr rzg mqk
lhf: nvh xgj fxk nvl ldl
dcd: njv hjk gsk
kft: cdj xmq xdp qpk hjk
qdw: dwq fbz
hkh: jlp kcq
vzp: cjt knx nqc znd jlg stf wmr
vkt: cqz jbd cvd lzb
ldl: rrf wbm rqt
vpx: css svg cjc lgj xkw
flh: hrc zwg rzz phl vzh fhz
gfq: jbf dft klf rtz frf kbm dbw xbr
bdg: lmk rvm fjn trz kwz
kvl: gzr hps gwb tpb zsn qlr vsf dbn mjn mkk
bnf: fxn
nwd: ldh rpt kbr thj sch lqn dxb
fjx: kbw lkr
fgs: swz xql tpf vnb rjp tjd hbk
xdk: gpg lgt zsd lrt
xzg: kjz mdg kgh klz tjn
xzm: pdk fhg bdf zfr pgx zpw hdk
kcq: ffl vsr
fgp: hqq pxj cjn phz tkm pvq vhd wzl
ljh: mnz xsl cmm cvk rbj tdh lfq
ccz: xkh cjd jgk mtg
jsg: hzs pqr kvp cgw jtj
qzv: mgm fpm jhh
scs: mxp hbk zcx
lhq: mrg gnp
ffm: bft mzh cst cgw kss
pbc: kjm kjp ppb
jhx: lnn rdt wxv
gms: cdg mss lfh
fpm: qzv gzd jfj cjp glk xzs wgk
vtq: jhx rvx hxw hpg
bck: kjf dqv
bzr: qgl
jqq: dgq wxq fph rdh
pdd: nzt tbj mkb
lfh: fcm gms hdv rbz tpc bft
knc: bps gnb ppm
ztk: cqd pcf lbd nxh dvs kfn kzc
llf: smd
pcf: ngk lxx
nvl: gzd qlr wjc lhf
dgv: hqj
cjn: ctb
rgb: qhr
psv: jbq wvf hqq djf vqm
wqf: pjl zml msb qbs jxz bnh pvf
hxm: fxd wkf vmh zrv sxj xlb kbw nvh
bqc: wjc tjn jgc wwk nhs mxp
rtt: ldr
llv: vrl tsl vpq rbj
cvk: ljh cqs
jxg: mqm dtd wmr rqz tls
xqb: mgq zhq gmf fft flf bdm tjh
kvm: plx cgs fjk mkj wxr mtx
fsh: mkn ffr szl zdf
dzl: zhd jcm jfz lrv psh wjc hvt dfq hfg qsg
kgs: cqc zxz knc rsh blr cgz
ctj: thj lhb bnt
sjj: kjm gzf
dfx: csn xhz pqm
ljt: gvs pkh lpl srm gtx
psc: vgw qsd whp wcf xzz zgg ksk tkm csg
nrf: xrw qml trb mjc
mbq: rsf crl cbz zmt rnx vgf
pns: vsb gdx lnn hsw qvg pfv
qzb: bxt fcg cnk vdr twn txn sdg xkv xtx
gxb: hzx
fnt: wcx vsb dkv mwq
hrc: lgm mdg dnm vqt rhw cbp dwr lkb flh
xhs: jdj rqz
hjp: cwm svs xwv
hqq: kcm fgp lpb zrs txv
ntm: cfs fbz drx txn mvx nbf klz
bph: npw pfx llt
hfd: bwc zrq zvx nqb dch hpq grq qwr
mqr: twn wpj xms vdw hhd
xjk: zcc npx xbc zrv
frk: glq bhw lxh pbc tns bqx mxd hrz dxh nvk
qdx: vsg cfr zvm mct
vjj: kjw scw txv sgr xpv sbc
zcc: sjq fcg xjk hgk xjm nxq
djn: ftb ngs rwl cwn
dpx: pmj prh sqq
jqt: cwp jvz fgg
wml: tcp mwz wpp cvq hsw mrr lxw pdb srt
gzr: rpw kvl hdk
rrr: slv vzm mtx mrr
lsr: zgg lhq
stf: vzp mjf
rzz: flh qzf
pgh: hps lrv nlk xfc
jrz: lmx ktw lgd qdn dxh
msb: xxm jgj
dmx: ldh mhb cbp dbl gjd spp
nps: ntz lsq
ttq: trz xpx fhz
vfm: rsf klv qwk xmp dpz lfc fwq
rqz: jxg rmb xhs
dkl: vnd wjl tkl
jdg: nrb klg lgc
cqd: vwk mnp qpk nhz txz pcg
grd: wxs phg lzc hzw ntl dcz ngc txw dfn jgw pvf
jvq: qgl fft hbm frf djg mbq sls qzm vbv bnn
rsv: czh nqc nqm
ptl: zch
mrr: pcg qzk
ghj: qgl wvb fcg
fgh: nbk xzj nxs lcj sfs
pvf: hxw wqf
wpb: jnm qqk bwf sfs vxk hnv
blr: vwq tns zdf
sds: zrq
qwk: tjf vfm
hzr: kpc gqf kzh qvq
qzm: mvk wwk hrt bpw txn
czh: ksk hbc jjd rsv vtx
hps: cwl wbl pgh jrc nnk nxq kvl
vfk: vkn tfr jdg
ddj: jdj mtx
whn: gbb
djq: xql mfl vfk jrk qpl rfx fqv vgf bnf
kqg: pcg lwm lzb plx lfv znd xdp
knv: hnv xzz cgs
gvg: jqj kzh zsg
cjd: slw pqd ccz cdj vhp prh krr qvs bzz
dnq: rtk
ssg: sgr mxl ctg ksm xgn mzr
nkp: ppb gnk ctg rxz rsl ctb
fph: kwf
gkn: pfk ffl qml nhs chc lrq
ftb: bpl djn jks jbq jbg
jgw: slh grd tcd drd
xfc: pgh mrb wsm
rtz: sls vkn dqw
bbx: sgs rhs kcb
vxt: dxh sfs
qkq: glb rsg
cmh: cpl pts nsk zml kfp
wxc: fhm
vgw: lzc ddj vzz zjs psc vnr
lbq: bcp nww lgm fhg jmj qpl
rbz: jgt frr kvp cvb tjf dvr tkx
kbs: dgd phg hnw pgl xtd
jtj: xlt nnk
qbh: ndc nlk vmk jzb jst
wjs: txf bdf qsg bnf stk rxq fsd
jrt: qbs jbr
xcz: gmq vwn zzb
fjm: gbb dkv vpq
vwk: lsx ntz zml frq cqd
zfw: zqz gqg kbr cbg svz
ckh: plt fkb nsk brt
znd: trj bdq qtb
rpt: jgf vdw
wxs: nnm lwj nfd jzq
fqq: gkr mdr gnd
wjl: xrw dkl jwj
tcd: xdd xfj pnr xwr fmt jgw mzr
gst: lfv nxs xbx vgk
zvg: gtf
kfr: pnm ljw tkl tkb fhg qzf
lxx: pcf wtp tpm cgz
ghs: rzz
mrb: xfc zrg
sgd: lhc sjj vzw
xwr: jzb vpj fll mct xkh
xbn: lkv scs gzr dxn dsw
lhb: hvt cql
ghn: dcm ttq qpq jxv mjc
jbq: ftb gcn
txf: gbm hqg gqr wjs hkh cgc rnb vtm
ltq: vwn jhh
zst: fhd
qhh: xjk xnr kxq tgm vst tfv xzg fwq wzp
pgg: tqf xbr jrc xlq zsd bvl
dnz: kmp rpw cwl gmg
kbw: nhs lkb vjd
twb: ndc sbq hxr fck lsr knx
zwj: dxb cwp
jxz: tqj ngk hpx wqw wqf
bwf: wpb gnp qsf
bqz: fcf fgv klz hbm
nrj: rnb lql mzh fjx
bmd: tkb srb
hlt: bdz cqc krt ngc kfn bwc nlc
fft: kwv xlx xqb kqx pqn
tnr: ksk
jsf: dbl vbm nvq bvl qmf srb
cfr: qdx gwj
wqv: wwr wzl lzd krc jdj
ntl: fkb grd pbz ldw
mwk: mtq dwq
rsz: nnl hcs zfx
vrw: vmh vcv dwq nsj rsf
qgq: sdc wml kjm mzj bpl xqr xbx
hrt: cvv qzm qmv tmt zxv tfq qcq fgg
tgb: msn wjl ghj
dwr: hrc ssz vtm lnc rtz xvd
pbq: gkx rqn klg
wmr: nfd bzp hpx vzp
mxg: qmf tfc ghv npx lbq bnt
lrq: pdw snk vhc ckt lkv xlb kss
dfn: qtf kzc clb xdv jcv lzc grd
gjl: phm wwr ljn cbt mgv vcg kpc
wbm: cpp
pqn: jlp bwb fqp
cnz: dqv sxj
rjp: lgm dss bcp fgs wdk
lqn: brp kbr spq sww
flt: bcf spb jlg lzc svg
kdk: zvx mnp ztl ssn scw szl shm lrd
mlx: tqz
cvv: hdv zcc mxp spq rmk jgr
ldr: jcv rtt fgc vlr zdl
xpv: pzp fzc mtr
nck: fdp rdh vnr jbr wvc
qpk: trj
ppv: txn pcv
pqt: nhh vlr mrw vpz jfq pcr bwc slh
hgl: qlh csq
zbh: src
bdm: fcg xqb mdm fjx xvd cnz zqr
cbp: cbz rzg vpb skz hqf xtb wzp dmx bft vxd mnv hrc
mjc: ghn brh tkl
rhn: lqg ljw zjc ghj vwn jdg
qtf: ctb lsq sjr pfr
vxq: sgg rnv qhq lrv wzp
rqj: txj zhd nzt
nfn: hsv gvg bdq lsv
tgm: dbw brh zcd mvc cvb
fmc: mxt khp
zdf: ktw
vhp: xzz mgl ksd bph jbq cjd vmn zfx
brf: txj
klz: ntm
qvg: kjp nnl
bvz: tcp pdb xdz
wpf: sjx zqr
bgj: rjf sbq jst lzb swk
sck: xcn zxz fdb qtz ksm
crg: ljz fkb fgc vmf wxq zst lnn cjg
wdn: xfw csq jqj kzp rdh kkn kgl
cwl: xqq dqv hps wsl qnj lkb vbv rpw wpv xdk dnz
mvc: tgm lnc wlk lsp
sdc: mrg vmn jbg vgk
tfv: qhh tmv
wkf: fhz wjl hxm
mgm: mss lkb qzv tpt sch gdb sdg
knx: vzp mjf rgb rqc twb phz tkv
rzf: ftz sss kpl fjj
mwz: mjv kzz
lmk: kts qkq bdg qmf
vhd: rvx csq
mxf: ghv xrw hpj tjd ssj
pkh: gtc ljt
nqw: wfk rqc htt sfs
xql: fgs cvc zsj
jwv: vtk dvx mwk fss bvp nbf
dvx: hbg nsj bxt
wjz: lwn zgg fqm blh fvp nps hvm
mxl: vnf hxw fpd ssg gdx fqb
ghk: gbk qsh gnk kcb
lnl: lfv vlv bqx gpr crv
mvk: qzm
rsf: vfm vrw ntm nrb cql dkc bth mbq crl
rjt: fvr sdh bdm bqg
xgn: nkd hhb hgl thb
qwl: dwq
rhw: djm cwm blc vbv gvs hgc skd hrc
rdr: lwr szl hhv zlk css jbq kvm whn
rcs: krf hvm
jsc: pcv pcn qrw npx dhk vxl
cbt: rcl jqq dws vwq gjl nkd
jgt: tfc
pqr: ckn lth mkb xfm
plk: gkv ccz gzs
kff: ngs gbb phm qcz pzq qjb gwj qwq scw
prx: shj htk
sjx: qpq xlt wpf kpq ljp tmj bbm fsd
mtr: cnv xdb xsn
mbl: pgh xqh wxw fvd cpp
bkk: jsf rfx dlg tkl hcr fmc pdw rvw
hbc: lzd ngc czh
jks: ftb sds slh bph hnw vcg lfq
bvp: hbg bnw gvs
hzd: hgl xzj fsw flv hbc mxd tcl
hnw: jks kkw zlk cvq fmt
glm: tkd fmq
cbz: cbp zqz snk
vqq: qcj hkl nrc
fss: jwv lwk nmc
ktr: wfk xts qsf ksm jqq rcs sgs ckh
nww: kcz
cgw: dcm
mzr: fmb cpd nxh gtp zzj prh ffw
hzx: hsv jfn vgw ndc wvl gxb lnn fzc cbt
wlk: mqc mvc hbm chc wpf xwq lwk
lkt: wpp xtd xqr tkv
kcb: ljn ghk
rvb: cvk wwg hpg zqb dlj
wvf: gwj xmq rjq
whw: hfz glk klk rqj
kfp: rvc bbb txw fkb
gnb: pfx frw knc fpk czd mgb
hhb: lhc mrv wxm xgn
zbw: rpr dqw
xfw: dcn rhs qwq tsz nsk zgg xmq tvs wdn
jnm: mzj lmx dcn krf wpb xxm
tsz: cwc gfj
nlc: hlt vgk qnv zbt
fgc: bzl zzt rdt fph
lgd: tmw nlw hsv cwc
hpj: vbv brs
xlx: fft fgg tkb nmm vws mkk
lhr: vkn wtw fxj ghn gvb pnm cbf hzs
nhh: bvq
nrx: dgv wcf zdl
jfj: jmq gxx fsz dnq lgc vsx
pgw: bxm zvx cdj pgl rdq
wql: lrt dwq zsj
jvz: csw jqt ngg lwk kfx twn xbc dxn rfg kfm ndx cql
jdc: kds jbr sss jgs bpk
wcx: kxz qvw fnt zqb
ffj: phm kfn xtd cqs
jrc: pgg cwp tbj hqg
gkp: rbt pbq spp dcg dfq fcf rnv
mkx: cgc zbh qsk dft tbj
lsk: rsw klv jfz xms tbj
jdj: xhs vwt srt bvz lsl plb ddj
kwv: fft tqf rbt zwg qsk
qxx: cbg sgg
hfz: xwl wsl ckq sch whw bnn
dlg: vqh vml pfk bwb xlt mvk tfr
nhs: gkn kbw bqc mrq
mwq: tpn xhd
kkn: jgk wdn fln
krc: jsm shg
zxv: ghc
gkr: fqq vrl
zvx: lsq hfd
knw: krt ffw kzh
vtv: fzc zhn
lsn: xqq brj
rrs: xcq bwd wvc rvx
mdb: bzp blm pzp vwh gtp nnm
vfq: bmm jgp mvx
dlj: dxz rvb lsl qtz mtx ksk cpd cpl
fxj: xgj dpz rqn tgb xvd cql
mbk: lrs rvc
xzz: knv pfr vhp vqm tcs
zkc: mgq mzh
cfv: rwl xdv sxr msb qtz fjj srt
dss: gbm
mkk: pqc wcm
sqf: kxz
stk: fcf hgc qtk
dvr: dbn dfp kts jqt wln gbr vwn bqq prx blw
gpq: fxk bxt mtq blx
wxw: vxl mpc hgc vml
wxq: jqq vlb sgr jgs hnv
tmj: klk tkx mhb sjx
qtb: bwf znd wxv pgl
rmb: kxm vcg btc rqz
sls: rlj mfl dfz
phg: grd cft jcs kbs
kbm: zhv xbc kwv
xnr: fxd wms
txj: vws nxf blt rqj xtb jdm ctn src brf
zcp: xlb xwq dph
fcm: sdv xms
zfr: tpb lmp lhb
lrp: lrk fqp dsq
tbq: clb wtt tcl bwd xcr wtf
jfl: bsq qsf
cst: mwx hqg vmd lrk kgh
nsk: xfw wxm cmh xhd
dgg: cjx xkv dft hhd kdp
srf: zml mgx dch hmb
skz: fsd qrb
tns: knv frk hvm rxj
nnd: wms drj
bwb: nbw dlg prq
cjf: lzd djf lrd bld
rmk: sxj ksw
rwl: bbb cfv djn ldn
zsj: wql zrg xql
mtq: jbf hgt gpq xgj rnv mwk
prh: mct mvh
drt: xpt xtx rsw qzb bkg cgc xbr czn dfz
lzb: kqg ftz xsx
kdp: zcx dgg
hcx: grg dfq snz
zfh: slv scw lpb ntz
wcf: sts lmx psc rxj
xmp: vfm pnm
sgg: wtw qxx cps dsw cxq
xkh: sdj hjk xwr
grq: tls tgk csq nbk mrg
qtw: ghs vbv wpf pkh bbm dfc
xms: gjg hkq fcm lsk ldh mqr
xtw: vsf gvs hqf ngg msn tsn czw gwn nxf zkc xnr
mrq: msn
wqw: jxz fmt nqc
hsw: wml txv
wlp: bpk wsd xqg xts wqw vzm lsl jnj
bcw: xqq vrs dkt kfr kwg mdf ssz
jnj: bbx zjs rxz tkt rcs qsd qtg
qsk: vtl xwq kwv tmt mkx vwn jlp rlj bdf
dtd: fjk vtt
hcs: gqf xpv rcl rsz dgw hpq mdq mcv qdq tdf
rxq: fdr wjs kmp
csx: lsx wxv kfp tmw jgj kgs
tgk: drq ksd wvc
qbl: thd fpk hnv tvs rwl
lqg: rrw vjd kbm kqx zfr rhn pkt dlh gvb nvh rqj
qtg: tqw kgt lwm nrd
vdx: wvl tls plt rcs
hpx: spb rrl nql vzq xmq fjj zhn jxz wmr
rjf: nkd pcf kxm
jjt: gsk qdq ftb fkm nzk tqj cqz
lfc: rrw qmv vfm ffp
qcj: gbm bhn mqc vqq
xjp: gsk fwk mkj bzl blr sxr
cft: lxh cls jgs
hxw: wvl mxl bqh kwf kgf dfx pvf vtq
zhn: wtt gnf vtv lcj lsv pqd blr
bcf: pts
fhq: mxt zcp
gxn: jxv gwn
lwl: rwh cgw qzv dhk
nxs: lhc fgh dch
qpq: ghn fvr mgm hbw
xts: ktr cvd fkx xqr vmk
svs: tpc
hvm: wjz mrr tns
vmk: mjv lpm
dtk: vrn fcf qzv nvm
qcz: frw sdq kff szl qbl
dlh: djg rfx
tmv: zqr tfv sdg tqf lcp fft ngg nvm
vzh: blt qmv pnx fwq xqh wwk
cxp: nnt blv rxj lsv lxh csn mgl hjw sbc mwt
cbf: lhr tfx
ptv: blv kkn dws bzp ksv
smd: kvp sww bgw tmt tfx spp llf hkh fmj
hkl: hbm
frq: tqz fpk xsn jfl vcq
cwf: cvc phl tjh bck cxq fpn xwl wzp vbm qvt
ldn: pxj lrd rwl xsl
lpb: gqf hqq qrz
hrz: hgp gzq
lfv: kqg xzj lnl dnh jrz gst
rrl: gbk mnz mfd jcv
tjh: xqb bzj
vcg: pvq btc rmb
jzb: xwr hsw dmg jgj kgf zsg djf wxc
fdr: rxq
xdx: hrp hqg sdv cbz
vlv: lnl fxx
xsl: zbt lmx ljh
fvr: dcg
bdq: nnm nfn lwn fnt znd
nsr: qjb
lnc: mfl ckn trz mvc dwr pqr ztn hbr
pnm: xmp kfr mpc zmt lth kdr
nqc: pjr jfn rsv wqw sgs
zrs: llv wjz hqq drd wdn pvf xtd zzt
kcm: btc bbb nxs jzq tfj bcf dth hqq txw
bsq: sbg xbx qpc krr jfl
wgh: xbq jsm tdf
lcj: fgh nfk zzj sqq
jlc: gtf jbg zfh zgg jfq zvm plg vzq
dwq: fpn qml mwk wql vrw xqt qdw qwl qhh qkj
tpb: kvl nbf mdl zqp vsr rvw zfr
jkr: xdv sjj pgv mgl lqp kjp
sdq: tnr qcz jqj rdh
ckc: dgv kxm tpn cqs qqk vgk
vzq: jlc dcz hpx tqd pmj
xdv: cfv lsl
ljn: njv kcb mtx
dxm: zds mkx qdw vnd lsn rpr tpf
fdb: czd sbc kjm zxb nbk
xqp: zqw dkv brt gcq lsq whp
jbf: rwh mtq
szl: qcz fsh sqf mnp
vmh: wtw tkb vrw dxn wpf zhv dkl ltq
vgf: cvs grg bkg mbq
jbg: sdc ftb llt xhd lzc lmx gnp kpc tcs qcz ftz
xzb: kds dfd wxq vcq skb nhz kgt lsx
qdk: gfr gqg rjt mdm
jcs: qwr czd thc mwz sbc
rqc: sjr csh knx
brh: hsh dkc
gtc: djm wjc srb pkh lql nrg dnq zqp frr ppv
cwc: tsv xpv lgd tsz kll
clb: fqb wvf
kjw: kds gjj ltx
pzp: dth sds xpv vhd
xsx: lzb dgv gjj
gmz: cjg mvh vcq dfd nkd krf cvd mgv
dwk: bbm ssj nrj bwb nvs dvp wvb hgt
rfd: tdx
rzr: fcf xhh ckt ccw
vmc: ljz ssn rsl vlr crr llv gfj
cgz: lxx gdx lpm
cqs: qdn shm gnk ffj mfd cvk
sxr: hqj dgq fgh xsl
nxq: gxm hcr
fqg: mjn ghc ckn gdb vsx zcc bwb fdr
lnn: hzx jhx dgq crg vpq
nzl: hrp jmq prq hgk kwg
fqp: sxj hbr
vlb: wxq rgm lsv
cbg: jqh zfw rbt hdv qxx gkn tkb
zml: jcp xcn wqf
vsg: rcv qdx dch kgf
mgj: plb fqq dvs sts
nht: lfv ldn pqj cjc
sdg: phl mqk qzb tmj mgm
fzv: zxv ddx jwv wvb mzh zff qpl
qjj: vtk xbr lql vhc hkh sjb
pcn: bbv qdk vtf dkc ljd jsc
zrg: svz zsj
bbm: tks dwk sjx tfq
bvq: pxj thd gvr xnk cmh pcr nhh
tjp: fwq lvb
tjd: mrp gjd glm
mtg: qkl crr
tmk: qnj wpv bqw ckn ztn
gbk: ngs wmr ghk gst cqc rsh lpn rft rrl
snc: hrz hmb bbb lwj
tls: jxg
prq: bwb rnb
nbs: phm lrs ngc vpz whp mpw pgv
pfz: cjt tqd lwj
tfq: cnk mkk zrg bbm ckq
rbj: llv ljh jhb
kfn: htt
xdd: lgj hjw tcd qww mgv ntb
gmg: dnz vrs
jgp: zcc spp lgt zff vfq srb gjd brp
llt: nbs pqj tfj sgr lpn kgl tdh tkv mdr bph
hrn: blt nrg wwk kbw rfx hkq
rsc: wbl ctn ljw
dth: wrc dvw kzz thb bdj wsd pzp bqx
txn: bmm ppv wjm
jfn: srt nqc hzx
sjr: rqc lgd wxm zqb
fwk: vnr
vpz: rxt pqt nbs
zcd: pvp hbk psp lkz tgm clt gxm
vqm: lqp
tfj: nrx kcm kkw fph
glk: fpm cjx xmp whw vvj lkz blc
tvs: xfw dcz tdx qbl
dcn: mqm
nbk: dcz hhb fgh grq qxl
mqc: wlk wcp jdh tqf rsg
cxk: xhh ssz lwk vrs
fcg: zcc bdm bbm dph qcq ghj
vhg: mdq jlg vbx vwt kgt
xfj: xvz mrv ppm
vql: prx zzb dhk hbg
hxx: zhq nsf
xqq: lcp bcw cgw jdx trb stk csc lsn
gxp: bdq ktw thd wfk tsl dzt mbk pgw
xtb: pdw nrg qnq
gnd: lxh qjb gnk
wxr: dxz lrs qdx lpm lwm fxg nxs
gmf: xqt jsc xqb pwr vmd
hkq: hrn lrk
sjb: qjj
hsv: tzb hzx lgd nfn znd spb pzq
kgf: hxw vsg jzb sgd dvw ztp vxk gwj sgs lvh ftz zfx
xkv: psh jrk dgg hgk gkx
cql: rsf pqn fxj jdm lql lhb zqn
tkb: pkh ssz vmh xqq bmd xlx pwr
wvl: vdx knc mrg cmm hxw xsn gst
kfm: wms fmc
wgk: fxn
wms: zhq vmh qwl vzd drj xnr nnd bqw kfm gxm
vqh: qmv qsg dlg nbg qdk hbg xpx
pdk: xzm tjd zsn pqc svs dph
jcp: zml cdf cvk wxq mzj kkw ppb
gbh: gjd lpl
zqp: jgc snz fsd tpb ckq
vgk: mnz qrz sdc
twr: ptl lnn gnp ztp cjc hbc fxg nkp ntl czd
bzj: xvd fdr zcx
sss: rlw rzf rgb
psh: xkv nfc mnn ghn ksw dzl
nrg: snk gtc gfr pnx wpj
jfz: xzs dzl
dgc: dgw fll djn skb
zrv: xjk zsj kvd
lsq: nps xqp zvx xgn qtf gvg
fjk: czd ctp kvm dtd qxl nsr
pmv: wsl czw vdr tpf
ffp: hqf
ddv: tbj tgb
dvp: dwk qmv hkl wpc mdl
wsm: xfc klf rfg mvk chc kdr tkx pnm bwb mwx cdg
lkr: src gtx fjx ccw
fxk: zqn lhf gpq nmm
zff: hbr
hrp: gpg nzl zfw tnl pbq xdx bwb hnp
xvz: xfj jlg rgb
pcv: ppv
lgm: hrc
zgg: jlc tkm lsr xfw wjz zvg
snk: nrg cbz
ngg: jvz xtw xdk
vcq: pnr frq ntz
btc: vcg
ksd: vhp tgk
tqz: ztp frq cvd ngs mlx
qhq: ddx rrf vtm qrb
pnx: dkt zhq
ffr: wzl whm pvq fsh
bxs: gvb shj qxx rrf gvj tfv
xwl: cwf czn
hgp: hrz lqp
gwj: kgf mtr bps lzd dgd dvw tgk djf ffj zqw cfr wvf sbq
wxv: qtb vtv fkx gxb vzz jhx nkr blm
shw: zzb svz
djm: mzh rzg lhl czw tsn klk hfz gtc
sdh: tjf
zhx: hgp mjv
vhc: dft cjx lrq qwl qjj fmj
bft: lfh kgh pnx kts brj hbg
vtf: bbg grg bfc vtl
vwq: rdq cbt rnp kpc blr
qvw: rsl xqg mrv jst
vsb: fnt
vkw: nfc wcp hsh psq
tfr: lhb rqt rvm
bqh: hxw nkk
cvb: mjj rbz sxj
jhb: cfv ffw gtp nrd rbj tnr
plg: qwr jlc
ftn: mss gbh zvw
qzf: jtv bqw rzz qmf cwm hkh
kxm: ckc rjf csg rmb kzc wpp gvg
wcp: lsp cnz wjm vkw mqc zcp
fsd: wjs qgl klk zqp
pfr: xzz pgn cjt mnp
vxk: sfs zrq lhc zzt nnt rvb wpb
tqw: qtg drd zqw gjj fqb gzq xfj
dcg: xlb vxj hdk cbf fvr mrp mdl
fvp: fkx lhq bps
fbz: qdw
mdg: gdr hrc qpl
tzf: tcp vmk psv
mdr: xmq pjl fgc fqq dfd vcg
nkd: gmz wwr
tkm: sdj
fdp: gnf ngt fgh rvx
lrw: gst vzm qvq ksv mrv rlw
dbn: hnp nmm pkh tfq glb dvr rlj csc
htt: nqw kfn zvm
zcx: xcf bzj
lwk: gqr nwd jdm lfr rdv kfx cxk rnb fss flh
fhd: dch zst
pxr: rlw qbx hjw mgx xzz rtt
mqm: jxg fxg
gbl: cjn crv kjp jbq bnh vtx
rdv: csc lwk
hmj: pqj skh lfq xzz fph pts hhv
srm: jwj dbn vkn ljt tpf xlt vnb
flv: hzd tcs bzz vmn rzf
zdl: mxd rcv
csw: rjj jvz hrr
sww: smd gmg jgf rpr gjk kwg sbr
mwt: xnk cxp zml ksv
drj: grg
wzm: jlg mcv csh
lzc: jbg dfn grd vgw
lmp: jqh dzq ffp zfr cbf mjn hgk
hqj: sxr cfr crr mbk dgv
lwn: sgs slv kcb gjj wjz tls tvs bdq wmr
gzs: rdq ktb bps
wzp: hgt fjx qhh blx
ddx: mhb fzv wwk rrc csc qhq
cnv: pnr ksv mtr qww pjr lwq vtt dvw ljz
nqb: lpn fhd fjj zrq lhc
kpq: xqt fpq bvp cvs fhq jsd
tpv: dbk slh qqk sts ssn cdj jkr
whp: nbs psc
bnt: mjc pnx lhl cjz
ckq: jgr
ssj: dwk vtm
crv: gbl sbg txz gsk
lkv: xwv vvj lrq xbn mqr nsj fsv jqh lgc
cjp: mwx qfm fpm qnq cjx
nsw: qqk xhz kxz hzd rrr
rlw: knv vlr xdp pxr css sss tsv fhm xcq lrw
ptq: gvj rmk mgq vsf ngv qjj
hnv: knv wxq
phl: sdg nvq
bwd: bqx jjd mwq
njv: dcd csp hcs flv ljn pcr rsv
lhl: zwj svz bnt bpw jsd bgw hvt
txz: crv sts cqd
nql: pzx
gvs: rhw zbh
pcg: ntz lwr mrr
vnr: nck sbg tqj wxc xdr xdz fwk
qkj: wcm dfp thj lkz hgc
pjl: nff shg
rvx: gxb fdp vhd
qcq: hrt cvs frr
sch: hfz gxn mkb
czw: pmv xtw nww
ffl: blw
gbb: dbk whn fjm vpj
zqz: cbz
xfm: zqn vqt pqr lkz kjf jgr hgc klz
sbr: sww qvt tpt srn fjn trb
gtx: lkr dbw ljt tjh dkl vrs
tpm: lxx tgn gtp cjt mcc
vwn: hcx gwb ltq xcz nbg dvr
rsl: fck vmc vwt nkp fsw qvw pfx
tfc: tks
csn: zst bdq nqw txv cxp qmz hxk dfx
xbx: bsq bhw dgd
psk: ngt ksd zsg cqz zst
mtx: dlj trj
jdm: lwk txj pdw jsl jtv
nnm: mdb wxs lxw hsw nnt mgj
kqn: cmm twb pfz jhx ssn shg
bkg: wpc fsz drt
tpc: prq fgv csc gzd bhn lfh svs
dcm: blt cgw zhq kbw mvc
dnv: gqg sdh fjn fhz
vzw: hqp zch tnr lvh slw
fqb: tqw hmb wtt clb mxl rdt rhs
dqv: zcp bck cwl cnz kxq
xgj: hxx gxm mtq
xdz: bvz lpn vnr vhg nsk
trz: lnc ttq pdn prl
jqj: gvg tqd sdq
dgq: sxr jqq gvx rqc
mhb: dmx ddx rfg
ckn: sxj lnc
brp: lqn bnf rld qml hdk nmm xpx bmd jgp
prl: fsv sjx qcq hqf trz lrq zjc xlq rld
tkl: hrr mjc
vnb: srm fgs
rsg: mqc xlb qkq cxk
khp: ldh rdv tbz
fqm: wjz wvc mrv
hdk: brp dcg
vmn: rsh lfq whp sdc
mrg: jbd sdc rqz lhq dtd qdx ztl
tmt: qsk zmt
xrw: mxf wjl nrf nxf gmg fxk
vvj: jgf lkv zds gvb dkc cgc glk czn
tpn: ckc zhx mwq nql mzj
hqf: dvp ffp jtv gbr cbp xhh
pnr: cnv cvd tcd xwr vcq flv
pzx: nql mgl tdf jbd fsh wtp wgz bhw mkl slv
zzb: sxj rjj shw kss hfg xcz thj bmd prx vql
nfd: whm lvh nnt wmr llt jbg nkp wxs txw cwn qvq kfn qxb
bnw: fvd vdw bvl
hch: jcv ctb lsl skb nkp xkw fsh
rsh: vmn tdf
dkv: fjm pfx gpr kzp
zmt: mbq pnm tmt mqk
rjj: rtk gvs svz cxq csw pgx hbk
vbx: nsr bzz hpg
rhs: qzk zdl kll lgj nlw nwz hzd fqb hvm bbx
vsf: gxn ptq mkk
lzd: hbc vpq twl gwj
fhz: wkf mqc flh dnv mnv nmm ffm blw qzb ttq kcq dkc
fmt: hnw nbc
mfl: djq hkl ckq glb cfs sls
ljp: zhq sjx lsn lmp jmq
ljw: mrp rsc kfr
flf: zwg rfg gdr xqb
zch: crr
tnl: fqv dft lbq ccw
ghv: mxg
rjq: glq txv hzw krf gnk wvf
gjj: kjw plk tqw nwz cpl lzb mpw twl rsz xsx
zhq: dcm qrb qrw pnx hxx
mkb: pqr
bld: ldw swk xdb
qnj: zrd mqc qfm wbm nvg lvb
ndx: jvz ghs cwl srn mwk nrb lpl shw
trb: nrf jxv zff xrw rdv cjz sdh sbr
nvq: jsf hdj dzq
rnv: fcf xqh gkp rvw
cgs: knv mvv
lgt: xkv jgp srb xdk bgw fgv wcm
vws: hqg xlx stm
ngt: ktw psk fdp kds
sbq: drd twb
pqj: llt shm ssn kbs nht hmj pqd
fln: qbl jgw bld kkn dgd xvz bzz
ljd: zpw jsc wpv gpg jsd
wdk: rjp pdn dlh gwb skd mwk
pfk: fmq qtk dlg kvp gkn pdk bbg wlw
qxb: jkr qcz fll nck nbz pts
sxj: rmk kbm ckn gms fqp cnz zzb cvb qnq
jdh: crl mqc
blh: wjz wcf vpz
dnm: nmc fmj rsc bzr jdg tkd dpz
cdj: qtf pgw cjd nwz kft wpp
bbv: jgt lsn jcm nvh ffp cvs vzd
thb: plb lpm
jgs: jdc xcr jlg qsh pmj cft wxq
bqg: rjt cfs vmd
nxf: txj fdr xtw lds
zqr: tmv
mdw: bvq bph ksv
zzt: vxk fgc bqh mnp
gzf: pfv tgn sjj sdj blv zgg css rtt
fpn: cvc spp kjz rrc
slv: pzx tsl zzj rrr zfh
qhr: plg snc bzp hmj rgb
cvc: cxk fpn xql lhb fxj gxn cxq nnd cwf
kvp: vrn jsg
tmw: lwr cfr csx kfn lgd hqq
mdm: tmj nql qdk gvj brj bdm
wtt: fqb tbq hjk
tcp: gpr bvz
lrv: pgh
sbg: tvp txz mvv dcz xqx bsq crv
lbm: zvm mtg lpn
zxb: rft htt tpp
lgc: jdg mrp jfj
dch: fhd qdn
qvt: sbr rsw xwq
rdt: cgz jhx fqb sbc fgc
bnn: jdg zmt
sts: txz tpv ztl wcf drq sfs
xhh: hqf cjp rzr cxk xcf
xsn: mtr tnr wvl
jjk: htt gtp hgl mqm xdr hzr wvc
sdj: gzf tkm xkh hnv vzm
pgx: rjj klg
ldh: nwd dmx khp
jfq: pqt jlc dws krt ssg pzq jzq ffr
vzm: tqd lrw wlp qdn mqm sdj rrr
fkx: cjg
wjm: lsp cfs zsj fvr bqq txn
nbz: psk krc
fhm: rlw vsb
hgt: wzp zhq mtq
tsn: nsf rsc djm
xqg: rfd nbc dmg whp kzc
pmj: vzz jgs zfh nlc fnt gst vzq dpx
vtk: jwv zvw qjj pmg
xzs: mxt fsd ftn jfz xfc ffp
dsq: lds lrp rlj thj pvp
cdg: jsl tjd gms gkx clt
xlb: zcp hxm lrq jtv kwg dcg
ltx: kjw mtr gcn wcx
mnp: cqd tsz
csq: hgl zst
nwz: ghk dws
tkt: csp ngt jnj kjm bpk
gpg: zpl fmq fqp xdk
wpj: klv pkt mqr
lpt: ngk xdb ksk kjm sqf wwr
dkc: rld mdm brh fhz nwd hvt pcn
klk: whw svs fsd
ccw: rzr hcx qzv lkr
gwn: qvt tfx nnd gxn cxk zrv
cdf: kgt dvs jcp bzl
kqx: bnw gjd
xcf: rjt zcx
tqd: vzm
zds: swz nbf vvj vsr dnv
lhc: hhb vxk nxs bnh
rxj: glq tns cxp wcf vkt
vpj: jcl
spq: mvk fgg rfg ghc cvv
gmq: hsh flj xcz
qvs: gkr xkw
ksv: cnv
blv: hxr ffw ptv gzf
dzt: pvf hrz sjj
nbw: dvx cpp vqt tqf gvj bwb
vnd: snz jlp zbw gwn dxm dkl
hbw: vst qfm xjm qpq vml qxr djq bmd ssj
vmf: crg ksk dgd zjs sqq
lpl: wtw ndx gbh hdj
qxr: rtx gfr bqq cgw ltq
wfk: grq qvw gzq rnp ktr sjr nqw
zwg: wjc pgx flh kwv vxj flf ssj gbh vfk
xlt: jtj dlg
zpw: rxq dsw xzm rlj
xpt: sbb nmc nzt bpw rnv
nsv: pfv qvs vzq nrd
tpf: pmv frj fgs kgh mwk
zrq: zfx xdv vlv xhz nqb vxk sds mkj hfd
mjj: wln ngv klf cvb
fjj: cfv
gjk: jwj llf gjg qnq
vxj: vdr
lsp: kts wcp rwh
phm: vzz nbs xqg ffj gjl cdf kff pzq
lfq: hmj qzk
kzp: dkv mvh pqd
bqx: wdn tkv lnl pvq zdf bwd bwf
mxd: hzd frk dvw zdl kxp
pqm: rrr fpk ngk skh msb dfx fsh
dft: gfq
lmb: bqg tjn kjz gmg
jcm: xwl tpt hgt bbv
zlk: xbq hnw rfd njv lwr pqt ntz fln vtq mkl
xpx: bfc npx ttq jhh kwg trz
jzq: fck wxs jfq
cht: nlb pzt vcg hgp kpc spb pns
thj: dsq qkj zzb
xhd: nps jbg mwq
nbf: tpb
jbd: pzx gpr csg vkt lvh mjf
mzh: fzv ffm zkc pqc fxk
twn: mqr vzd jwv
plx: kvm kqg hnv jfn vzz
skh: pqm hmj nlb
hhd: dgg lgm qfm mqr
kdr: blc bcp dms xcz wsm bzj
qsg: vqh qkj zsn fgv ghj
shm: ndc pqj
rvc: mbk rgm kfp cgs zml
dnh: lfv qtz fpd
rrc: dkt tpt mxp tfv hcx
kpl: ktw mcc rvj rqc snc mqm rzf
cjc: nht vpx nvk vqm kqg plk plb vbx vzw zsg
ltr: pfv fxx vlb ssn
qbs: tsl jrt kds zvg
ngc: hlt mpw csg nbs hbc pdb
frj: jrk gdr tpf lkb kgd
dbw: tgm nww dfq jsl hsh
mvv: hhv gpr cgs
gdb: fqg xwl bgt cjz
czn: vvj fzh cjz nfc xwl zqz hjp
pwr: xgj ssj xlt hkq
vtx: gpf
zvm: qdx lbm
mcv: zvx xdr wzm jfl nhz wfk cvq kkk hqq
brj: mdm pkt lsn qtk xlb
krf: lwq jnm rcs rjq skh nxh tkt gmz gvr
dws: snc ptv pcf nwz cbt
qpc: nqm bsq
mrv: qvw xfj hhb
nfk: lcj ptl
cpd: vqg dlj mzr
glb: xlq wgk vtm qkq
hjw: pxr
blc: jdx qzf tjn pmg kmp glk kdr vmd
jjd: bwd xsl
kfx: lwk nvs
nmm: xlx
bqq: lwl rzz wjm
qwr: knc ldr plg hnk hfd jcs trj pzp
mjn: fqg wpc lmp
wsd: wlp mnz nnl hzr tns hqq
wwk: ddx vzh qzm bqc
bzm: mdm rld tfn dpz hxx gmq
tfn: lmb xqh tfv
vdw: mqr
bbb: mdb snc vhg vwk rwl zvm vmf kfp
krz: vtv czd jdc zfh tqj ztp
rpw: gzr
hbm: vxd qrw hkl rqn wkf zvl jvq
frw: pjr gnb qcz nql
spb: cht dbk
lwr: tmw vsb mgb ztl fwk fvp pcg
qzk: nps jhb mrr rhs lfq
krt: mpw knw mdw
zsd: pgg xdk nvq bqz tjh tkx mnn lsn
vzd: nww pvp cbz twn fxn
vst: nbg fzh rrf qhh zfw
gfr: gbm rsw nrg
mjf: pvq jbd
bhw: bpl xkw dxz xts xbx
lqp: hgp mgj tzf lkt vqm pcr
nnt: nnm sgs rsz
wzl: wqv
dnd: jdx nbg bhn qrw wlw
bcp: dxb rjp
qrb: skz
nmc: xpt dnm jlp
kjz: lmb fpn
bzz: flv fln cjd
mnz: tpv rrl wsd rgm vgk ljh bzl fkx
vtl: qsk hcx vkw qwl xwl
mgq: xhh ptq rzr zkc sbr mnv xqb
mcc: rwl vlb qtb rtt kpl jdc
twl: nnl vwk gjj lzd wtp nkk
zhv: vmh tkl zbw
xqh: jgt
slw: hxr vzw cjd
hfg: zzb mnn
xvd: vdr bdm nmm dwr
mrw: tgn nql kxp
ztp: gvx twr knw lrc mtg
fvd: bnw qtk
qjb: sdq nkr jqj qpk rbj gnd nsr bnh qvg mgv
kss: srn lrq zsj dpz
rnb: clt jqh bqz prq nrj lwk
tcs: xzz flv lpm
lql: nrj qjj
vbm: qrb cwf xbr
pgv: nbs brt fzc
rcl: vqg blm ngk cbt
nnl: twl qmz rsz
wpv: cwm mss
fxd: tfn brf xtw kvd xwv gvj mbl xnr hxm
xcq: rlw plg lpb rcl rvx rrs
wsl: pmv
kwf: hxw fph mdq
mjv: rsz fkm nrd vmk zhx mwz
wbr: bbx wtp hgl dzt
mss: mgm ftn frj mrq xzs wpv spq
ngk: jxz rcl pqm pcf dxh
lkb: cwl
lrt: wln xdk
tgn: gzf tpm cjn
lrs: wxr vlv mbk nfk
nnw: clt pdn jsd tbz qpq
xlq: prl
bpk: tkt kxp fhd
rsw: qvt gfr qxx lfc lsk qmv kgh
dpz: bzm dnm kss
tks: jsn wpf hdj vkn mfl xjm bbm tfc sjq
pjr: nqc wvc sxr thd hpq frw
rfg: flf mhb spq wsm
dfd: kjp xbq mdr
lbd: csp nrx hqp kkk sds ztk cvd ksm crt
brs: frf zzk frj hpj mwx rtk npx
wwr: wpp wqv lpt lnn mvh tsv rbj dkv gkr ljz gjl nkd
xbr: gfq swz qjj vbm drt
dcz: zxb tpp nbk tvs grd drd vzq mgx
wxm: gfj tqd
kzh: mct hzr
rxz: wxs kpc nkp jnj krt krc cjg
vlr: ldr fkm txw lvh
ktw: gxp ngt zdf pfx
bmm: svs dnv tpc vfq txn lds blx bck
rqt: vtm ldl
qfm: qnj xcf snk cjp klf hbw hhd
mkj: xjp kvm
fqv: djq tnl wpj ftn
rfx: bkk tqf dlh jtj ctj glm hbk
fgv: lgt hhd mdf bqz vpb
jtv: qzf xlb
hxr: twb cft gkv fxx hjw slw blv
ctg: nkp ssg pfv xcn crr
kgt: xzb qtg bqh
nvs: hbg clt jtv
jdx: blc llf zvl dnd jdh jxv
nzt: pdd rqj
krr: bpl sqq svg vdx gfj bsq fmt
rtk: brs tmt bzr bnn gbr ffl dnq
ssz: tkb bcw cxk
rft: nlw xxm mvv nbc zxb qhr
jrk: djq qwk frj
jqh: zfr lmp rnb cbg lkv nrf wlw kfx kdp xwv rpr
wjc: xqb nvl lcp vxl gtc bqc csc nzt ljp zwg dzl
cjz: bnt pmg zjc dfc trb gdb qzv pqr
mxt: xzs fhq fmc pbq vxd vvj
hdv: cbg wcm
lxw: dxz wml nzk
zpl: gpg jfz vbm fjn gfr ghs
kzz: mwz zjs zzj
nvk: frk bqh
xbc: jvz xjk gtc kbm mrb
xdr: pqd
gzd: gdb bzr npx nvl
tqf: pgg tmv vcv xzg hbm kwv zcd mqc rfx nbw sdv
pkt: pdn wpj
gnf: gfj zhn xmq gxb mvv pzt pzp fdp gpr jcv cfr
sgs: nqc nnt wzm
mzj: jnm qgq tpn kgl jcp
nhm: wpb lrc cpd nnt rcs
txv: csn hqq vjj rjq hsw rvb
rrw: lmb vqq vzh kbr lfc qgl brf
xwv: hjp mrq wbm mvk kfr lkv mqr zqz
cjt: vzp zzj tpm pfz pfr
fmb: nkk rnp rgb
nzk: hzw jqj lxw qtg
jsl: vsf jgf dbw vxm zhd
mgv: gjl
tdh: hpg xcr ljh llt
jmq: sjq fft nzl jfj nvl ljp psp
kll: cwc whn rfd
nnk: hps lrv jtj
jhh: fxn qzv xfc jrk
qqk: wpb qxl
jqp: tmt tjd hcr cvs
gpf: vnf xkw vtx lsx pcr gzs xfj cpl
fxn: vzd bnf
slh: xzj jgw jks
swk: rxt bld qbx bgj xdv
wpx: rgm kds
xcr: tbq ntb jgs
nbc: bwc tsl fmt
vrl: llv thb jfn gkr
vqg: xnk jxg rcl vcq cpd
zsg: jzb psk
vrs: gmg gtx cxk vdr
tdx: tvs skh nbz rfd vmk gnk
hgc: rhw wxw vtk vws xfm cjx
fzh: kcz gkx pgx czn
dvs: cdf rsh mgj xdv zbt
cwn: tcp kzh wzm xnk kkw hjk
xwq: wlk qsk qvt xlq psp zhd dnz zcp
djg: dlh jsf mjn hqq
cjg: gmz fkx
tsl: gxp nbc vpj
hsh: brh cxk dbw bzr vmd ssz vkw gmq
cxq: sgg cvc cnk glb dbl
pqd: kzp vnf qww mkn zhn bcf pqj xdr
dfp: gbr gjg
ffx: gbl knw tns scw cls tbq
crl: fvd mbq jdh zwj mqc
pfx: dkv gnb gls
thc: jcs nbz mpw shg
dms: brf kdr htk jgc
kjp: gbl dfd nqw pbc qvg rrs rrl
kgh: bft cst rsw jwj tpf mjn vhc
klv: wpj kmp xtx
gcq: wgh plt qsd tzf rtt plg
cqc: kgs gbk mrv ktr
vxl: jcm dbl fcg wxw lmk ztn sjb tgm jsc
zvl: dzq fsv
drx: rmk lth nnk ntm jmj scs
lrc: ksk nhm xdp ztp sgr mgj
hcr: jqp nxq rtz gbh qhq
gcn: gsk ltx
vxm: qpl vfk vsr qkq bgt
kds: ngt zxz qbs xzb
rpr: gbm lkr sww zbw vsf
mvh: kzp wzm prh ppm
wtf: xzj cls hpq
zjs: vgw vmf kzz gpr jgj
gnp: bwf
qpl: vxm mdf djq
grg: dnz vgf ljw wql tjp hcx ddv drj jdh
gvr: bvq krf btc
fll: qxb zfx lvh
cmm: ljh brt css
lth: xcf pqr
xdb: lpt zfx mtr
klf: qfm jgt ckq
rvj: bwc phz cfr ldn bxm
cpl: dlj
mgl: cgs jrt
vtm: txf rqt
fwq: vfm vzh lkz
hzs: czw lhr jsg
jgf: jsl sww vvj
hbr: xtx jsn zff ffp lnc fqp qzv
gdr: stm mdg cnz mxt mxf frj flf
vpq: fjm
ztn: lnc nvg mvc qnj
xfb: bft wln rnb tpf rtx nvq
lfr: hxx jxv tpt lwk xjk bqc ltq zzk snz
rqn: fxj sdh qdw pbq bqg
pvp: mnn
kts: bft lsp lmk vbm qcj
dfq: gkp jtv
gvd: vtv gcn htt xsn ztl pbz sqf
hrr: csw jmq svz tkl xtb nrb whw sjq
gls: thc pfx jbd ksm hxk wqv
fgg: jqt nfc ddx spq nnd
mrp: ttq lgc ljw tjd rpt ksw cfs
nrd: lgj zch
fpk: gnb frq gvx fzc qbl
cvq: mcv
fcf: vpb bnt rnv dtk jbf bqz stk rzr vsx
pdb: bvz wml
fck: czd pjl qpc jzq qvq
lcp: lsp xqq jsg ccw
pdn: pkt nsj
lmx: wcf jnm xsl
gdx: cgz
gbr: kmp bhn rtk bck nvg rbt hqf dfp rvm
vrn: mqr kvp lnc
brt: pgv xqp
qxl: nbk gnk dcd
jgk: zxz wpp kkn
jsn: hbr kdp glb lrk hvt zxv
zjc: rhn prl pdd
qnq: xtb sxj cjp xcz
kwz: qlr cwp bdg wpv wsl fhg
mdl: vsr gvs tpb
hmb: fqb ppm pdb
mwx: qtw wsm zzk brs cjp pcv cst gqr
jbr: tcs jrt jdc
xkw: gpf hch
zfx: nrd zrq fll
mvx: zpn gpg chc ctj vfq pdk lrt
wlw: jqh zpn
tjf: rbz dpz khp mxf dfc qwk sdh ksw gkn nnk
klg: jdg pgx nmc
bdf: wjs snz
bxm: ghk psv slw pgw dgd rvj knw
hqg: xdx cst
gpr: tcp lnl
qlr: kvl nvl ssz kvd fsz kwz nxf
zxz: sck
fpd: mtg cgv dnh xgn mgb plt mxl tcl
jwj: nzt gjk wjl kgh bnn cxq
blx: bmm fdr gpq
chc: wsm
hpq: wtf pjr csg xhs fhm
kbr: lqn
ssn: vmc sbc kqn ltr
bps: knc gwj fvp gzs
hjk: xkh lsl
rlj: dfq qsk sls dsq
xqt: rqj hxx gmf kpq lth
wwg: rvb pfr kxp jxg txz fxg vtt xqx
nsj: pwt dvx gmq
gqr: mwx spq
tbj: mkx ddv lsk xtb jrc pdd kcq xlt
vml: lrk gmq fbz
cvs: kpq lmb wbm bbv jqp fss vgf qcq
drd: tqw dcz rxt sbq
bth: ghs nnk ctj wlw
phz: fgp
gqg: jgc
srt: jdj hzw lrd
cfs: mrp ntm mfl bfc
pxj: svg bvw fgp scw fdp ldn bvq tkt
vnf: nql dmg nvk qtf jst mxl pqd phz
qrz: djf zsg wgh lpb mqm rvx vgk spb
qsh: qmz jst ghk
mdf: qpl srn
qbx: pxr tns swk gvr cvq ccz
wbl: kjf fmc ffm pmv rsc
dzq: lmp zvl
nsf: fft rfg tsn fpq hxx pqn
psq: grg mtq lkv fsd dlh vpb mjn vkw sgg zqn
lpm: cgz tcs thb nff lwm vmk
mct: rsh prh kzh
dxn: jvz zqp cgc
pwt: kqx rzz lds nsj zrd cps hjp zfw
jgj: csx msb kcb
csg: ngc kxm mgb hpq
hbk: ghv zcd rfx
vbv: jvq cwl gwb mpc qtw fxk hpj
qww: cnv zqw fzc bbx
rxt: swk drd fmt mgx vpz jcs
ctb: hhm nkp cjn crr hch qtf xdp
vkn: srm vfk jrc ghs glm
bnh: gbl tkv vmk
qvq: nfd lrw
bfc: xtx xpx vtf cfs skz
txw: gzq kcm kfp
xbq: ksk dfd wgh ksd
lwm: lpm lxx
fsw: jsm rsl gxb jfl vpq
swz: xbr fgs ckn zds
jgr: gkx cvv ckq mrq xfm ckt
bdj: mlx fck xsx ptl djn
src: pgg lkr zbh
sfs: nqw
vzz: wxv
pfv: zbt pns
wln: mxp lrt rjt mjj
sjq: hrr xlq khp tks
mxp: cvv bqc scs rrc wln dms
mnv: cbp zcx glm
hgk: dbl zcc nzl
hzw: grd rjq
wvb: jdh xms ghj fzv mxp
rrf: kjf vst bxs xvd qhq ldl
qkl: zrq nff dgd frq pfr xqr mtg kjm
rnx: msn gxm wbm fpq xmp mbq
wcm: fqv hdv jmj lgt mkk lcp qkj qmv bdf bkg
mdq: cqz kwf dgq hcs nlw kkk
hvt: ngv lhl bzr lhb
vxd: mxt hbm jmj nnk vnb
fhg: kwz ttq dss xzm
kgl: wvf mzj wqw wdn
gnk: cqs gnd ghk rjq
trj: qwr znd qpk mtx
svz: rjj zrg
dhk: lwl
nkr: jrz wxv xhs mxd dxz fxx wcx qjb
dbk: spb gbb qlh gls ldw tpv hqj
wtp: pzx lxx
tbz: qml khp blx
zbt: dvs nlc
mpw: krt
bzl: xjp cdf mfd fgc
nxh: krf mzr ztk
gjd: brf tjd gbh
kcz: fmq fzh ccw pnm nww xlt
vdr: kbm nzl vrs vxj zbh jsd xvd dqw
djf: jzb qrz
crt: vtt ckc vwh
qdq: jjt xcn qmz
ntb: xdd gnb xcr ntl kjw wcx jjd qsd
zqn: skd fxk cnk brf gmf
ctp: xbx bdz xnk pgn
dvw: vsg lhc gwj pvq vpx qvg mxd
kxp: mxd bpk xhz qvq mgv
kzc: dfn
gbm: rpr vxd qcj gfr gjg txf dss pcv lrt
pqc: vjd zhd qnq dgg mzh mkk
hhm: xsz csq kft tgk pcg
blt: rrf frr vzh tjp
jcv: gnf rrl hch tfj wvc ldr blv ftz cwc xcq
bxt: gpq vqt dvx qmv lfc
csh: mkj qlh rsv dcd gdx xpv wzm rqc
lvh: vzw fll
fsz: bkg kdp
lpn: lbm nbc gbk xdz nqb
pmg: cjz xlq mdf psp vtk zrd
shg: kqn thc
qmz: nnl qdq xtd qsh tpp
dqw: vdr zbw bpw rtz nrj lkz zbh
ktb: trj csp gzs tfj cwn hhv jrz sgd dpx
xmq: xfw kft wvf xhs
jmj: bnf snk
tjn: blc ppv xzg brh
ckt: jgr rzr ksw vcv ngg psp lrq gxn
csp: jqq txz nfk xdb
hxk: thc nql rrs csn pqd hhm zch wpx bsq wqf
qtk: brj mrb pfk
cgc: mkx vvj dxn txf
gvb: lqg bxs fzh zvl klg
nvm: dtk dnz cpp wcp tbz
tkx: tmj rbz zsd
pvq: mjf vcg ppm
tsv: tsz jlg vtx
npw: gqf pvf csk bph vtx
dbp: mjv tsv jgj vwq phz wxm
frf: jqp xbc vxj bzj jvq
pzq: jfq cqz kff
zzj: lcj slv cjt
thd: gxp qbl bvq zzt
msn: tgb mrq jqt vrw xtw rnx shw
dgd: bxm qkl vmf xbx sgd kbs
zrd: qnj pmg vsr
qmv: ksw bxt
dbl: dmx fcm jsf
qwq: nvk mzj knv dsm
jst: vnf qsh
spp: gkp smd dft
tpt: mgm jcm sbr chc
tdf: rsh hcs
nff: sqq vhg qkl nxh pjl lpm cht fdp
fxx: vlv
dph: pdk zcp
kkw: jcp cwn
skb: xzb btc
fsv: prl zvl zsd mhb gkx vkn flf jxv lkv
hqp: lbd wxs vzw bzp nfk lwj
lsl: dlj hjk jdj xdv
tqj: jjt jxz skb gqf
ffw: ztl qvq knw zvg
rtx: qxr tfx vcv prq sdh
jcl: srf qvs cjg kzh vpj nsk fln
mpc: wxw vfk lrp hfg nbg jdh
vwt: jdj drq pzq lxx lhq
dsm: xcn nnm qwq vhd jbr
ngv: ptq
vcv: rtx vrw tqf
glq: nsw kxm wbr frk rjq rxj
qmf: ldl skd lmk
crr: vmc ctg lwj mtg zch
fkb: ckh kgt ntl
rnp: zbt vwq
nlw: rhs rft shm cjt hnk lgd mdq bdj
xzj: fgh dnh
gxx: vml vzh lds bbg fbz jfj bxs vfq
plt: fpd ckh vdx
drq: xxm vwt
zzk: brs lfr skz mwx
xqx: cgv gkr nhh pgv
kwg: xpx sww vpb dss
stm: bcw vws gdr mgq kjz csw dxb rjt
ljz: cnv crg mdr nsr ngs wwr
kgd: zkc dsq ghv frj dfp lvb
kkk: plx bph prh mdq vrl sss
qdn: vzm dch
cgv: gkv
ngs: tqz gbk wrc
pdw: xtb lrq jdm
lwq: cnv mgx vdx bdq psv krf
bwc: hfd hlt
xxm: jnm msb skh plg drq
lds: whw npx dsq bmm nxf
lwj: hqp pgn crr
xhz: kxp
psp: mpc pmg ckt phl
qsf: bwf vxt jfl
zhd: rqj zvw hkq
jsd: lhl kpq qzv
hnk: qwr rsz vpq bdz nlw stf
qtz: dlj dnh lsr kpl fwk xcn sck vdx
cwp: jqt fjn nzl hzs zwj jrc
tkd: qwk gjk cgc kwz dnm kxq glm
sbb: qtk kxq vcv gfq dzl xpt dfz kwz ngg
bvl: pgg ltq bnw tjn qdw jsf
clt: zcd nvs nnw
xqr: lkt pfz qkl gnd qgq
ghc: spq prq bkg fqg gwb vrs zxv
jlg: flt tsv wzm ccz gnd xvz
srn: sbr tfx nbf
ldw: ntl pfv bld dcn kvm
qnv: cdj htt lxx csn dmg wrc nlc
cvd: pnr vkt lbd
cps: sgg dlh wql
blm: mdb
kvd: vdw
dxb: gkx zwj fsz bcp nwd
gsk: jjt crv gfj
bdz: blh sgr vkt htt mkn hnk
qsd: gcq zhx
vqt: wgk hrc
tzb: vxt nps zqw jrt bbx sqf
cwm: qzf qwl hjp wpv
czd: xhs vzw jcs twr fck fdb fjk gnb
kxq: sbb ctn
vtt: dtd fkm lfq xmq tmw crt
xtd: jjd bzp
sqq: krr mkn tzf lcj dpx vmf
gwb: kvl vbv ghc wdk vwn
nrc: wln vqq hgt xbr gxx gms mqr
bzp: ptv hqp
gvj: nbw bxs dbl
pbz: csk nkk
jlp: pqn xcf hkh nmc vnd
nrb: fcf lkr hrr lmp hzs jdg
pts: qxb hmj cmh
gvx: ztp wgh fqm fpk kzc ptl
hhv: mvv czh tdh
plb: thb mgj gtf lsr jdj lbm tnr
lgj: vpx
lxh: lhq cxp frk qlh gnd
jsm: jrt nnl wgh bps lpb krc fsw
cpp: mbl nbw nvm nbf
xtx: ddv zqz klv drt bfc hbr
ftz: rzf jcv kgf lzb
vjd: fhq fvd vqh kbw djm cql pqc
svg: krr fsw
mqk: zmt hkl qgl
rdq: vwh vwq sdq pgw pbc lwn gzs
ksw: mrp tjf qmv
csc: tpc bkg sjq rdv ddx
xdp: kft plt ctb
rwh: bmd pgx lsp jbf pbq lwl
tvp: csk nwz qpc pvf qtf sbg gbl
nfc: xlb pkt cnz ngv mrb vkw rpw
fxg: pjl mqm
fkm: jjt xsz mjv xsx vtt
